1111111111111
100100000001
10C0011111011
1P0011E000001
1111111111111
