1111111111111
1001000000P01
10C0011111001
100011E000EC1
1111111111111
