1111111111111
1001001000001
10C0011111001
1P0011E0000C1
1111111111111
