1111111111111111111111111111111111
1E0000000000000C00000C000000000001
1010010100100000111001000000010101
1111111111111111001111111000010101
1P0000000C00C0000010000010000000C1
100000000000000C00100C001000000001
100000000000000C00100C001000000001
100000000000000C00100C001000000001
100000000000000C00100C001000000001
100000000000000000100C001000000001
100000000000000C00100C000000000001
100000000000000C00000C000000000001
100000000000000C00000C000000000001
100000000000000C00000C000000000001
1111111111111111111111111111111111
